NO ./textures/NO.xpm
SO ./textures/SO.xpm
WE ./textures/WE.xpm
EA ./textures/EA.xpm

F 220,100,0
C 0,40,240

11111111
10000001
101S1101
10111101
111  111
11111111