NO ./textures/NO.xpm
SO ./textures/SO.xpm
WE ./textures/WE.xpm
EA ./textures/EA.xpm

F 220,-100,0
C 225,30,0

1111111111111111111111111
11000000000110000010000001
10110000001110000000000001
1001000000000000000000001
111111111011000001110000111111111
100000000011000001110111111111111
1111011111111D11100000010001
11110111111111011101010010001
11000000110101011100000010001
10000000000000N01100000010001
10000000000000001101010010001
1100000111010101111101111000111
11111111 111111111 111111111111